1111111111111
100100E0C0001
1000011111001
10001100C0001
1000000CPC001
100C1100C0001
1000000011001
10000C0000001
1111111111111