1111111111111
100100EPC0001
1000011111001
1000110000001
1111111111111