1111111111111
100100E0C0001
1000011111001
100011000P001
1111111111111