111111111111111111111111111111111
100000000000001000000000000000001
101111111111101011111111111011101
10100000001P00101C000001C10010001
101011111011111011110101010110111
101000001000000000000100010010001
101111101111111011110111011011101
10000C10000000000001000101001C101
111011111111111111010100010110001
10000000000001C1C10101C1C10010111
101111110111010101011111111010101
1000000101E1010001010000100010101
101111010101010111010110101110001
1000010100010001C1010010001010111
1011010111111101010111101110101C1
101C01010000010001000010001000101
101111010111011111011011101111101
10000001000101000101C010000000101
111101111101010101011110111110101
1000000000010101C1000010100000101
101111111111010111011010101111101
10100000010001000001C010100010101
101011110101010111111110111010101
100010C100010101000001001C1000101
101110111111110111110101101110101
100000000000000000000100001C00001
111111111111111111111111111111111