1111111111111
100100EPC0001
1000011111001
1000110000001
1000000000001
100C11000C001
1000000011001
10000C0000001
1111111111111