1111111111111
100100E0C0001
1000011111001
1000110000001
10000000PC001
100C110E00001
1000000011001
10000C0000001
1111111111111