1111111111111111
100100E0C0000001
10C0011111001001
1000110000000001
10000000P00E0011
1000110000000001
1000000011001C01
10000C0000E00001
1111111111111111