11111111111111111
10000C1C0000100C1
10111110111010101
100C10000100C0101
10111010010111101
100C001C0101E0001
10111111111111111
1C0000000000000P1
11111111111111111
